##z#################
#a    u       #  x #
## ########## #  # #
#   h   #     #  # #
bo##### #### ##  # #
#  #    #       ####
#  #### ########a  #
#  #    #    x  #  #
#  #      ####     #
####################