##z#################
#au   w       #  h #
## ########## #  #x#
#   h   #     #  #c#
bo  ### #### ##  #c#
#  #    #       ####
#  ####x########a  #
#  #    #    x  #  #
#  #  a   ####     #
####################