####################
#c            #  w #
## ########## #  # #
#   x   #     #  # #
####### #### ##  # z
#       #       ####
#  #### ########a  #
#  #    #  x    #  #
#o #      ####     #
####################