####################
#au   w       #  h #
## ########## #  #x#
#   h   #     #  #c#
#   ### #### ##  #c#
#  #    #       ####
#  ####x########a  z
#  #    #    x  #  #
# o#  a   ####     #
##b#################