####################
#au   x       #  h #
##u########## #  # #
#   h   #     #  # #
#   ### ####h##  # z
#  #    #       ####
bo  ####x########a #
#  #    #    x  #  #
#  #  a   ####     #
####################