z###################
####################
##########        ##
##########        ##
bo                k|
##########        ##
##########        ##
####################
####################
####################
